лллллллллллллллллллллллллллллллллллллллллллллллллл
н          лл                   л                 
н л ллл лпллл ллл ллллллллллллл л лллллллллллпплл о
н л л л лA  л   но       л   л   л л       л тл  о
н л л л лмл ллл ллл ллллл л л ллллл л ллллл л лл лл
н л л л л     л   л     л   л     л л л        л  о
н л л л л ллллллл ллллл ллллллллл л л л ллллллллл о
н л   л   л     л       л   л     л   л     л     о
н лпл л ллл л л ллллл ллл ллл ллл л ллл лллллл лллл
н  Eл л л   л л   л   л       л   л   л          Zо
н лмл ллл ллллл л л ллл ллллллл ллллл лллллллллпппл
н л       л   л л   л   л       л л     А       щ  
н л ллллллл л л ллллл л л ллллллл л л лллллллллмммл
н л л       л л   л   л л н  л     л             о
н л л л ллллл ллл л ллл л ллл л ллллллллллллллллл о
н     л л       л   л   л   л л           л       о
ллллллл   л ллллл ллллллллл л ллллллллллл лл лллллл
н       ллл л   л   л     л   л   л   л      ны   о
н ллллллнBо л л ллл л ллл л л л л л л л л лл лллл о
         л   л   л     л   л   л   л   л  л      о
ллллллллллллллллллллл лллллллллллллллллллллллллллл
