лллллллллллллллллллллллллллллллллллллллллллллллллл
н          лл                   л              л  
ллл ллл лпллл ллллллллллллллллл л л ллллллллл  лл о
н л л л лP  л     л       л   л л л л   нYо л  л  о
н л л л лмл ллл ллл ллллл л л л л л л л л л   лл лл
н л л л л     л   л     л   л     л   л     л  л  о
н л л л л ллллллл ллллл ллллллллллл ллллллллллллл о
н л   л   л       л               л               о
н л л л ллл л лпллллл ллллллллллл лпллл ллллллллллл
н   л л л   л лS  л   л  Fл   л   лT  л           о
н ллл ллл ллл лмл л ллл ллл л л лллмл лллллллллпппл
  л л     л л л л   л   л   л   л л    А        W  
н л ллллллл л   ллллл л л ллллллл л лллллллллллмммл
н л л       л л   л   л л н         л             о
н л л л ллллл ллл л л л   ллл ллллллллллллллллллл о
н     л л   л   л   л   л   л л         л л       о
ллллллл л л ллллл ллллллллл л л ллллллл л лл лллллл
н       ллл л   л   л   лXо л но       л         о
н ллллллл л л л ллл л л л о л ллл ллллллл лл лллл о
             л  л   л л   л              л      о
лллллллллллллллллллллллллллллллллллллллллллллллллл
