лллллллллллллллллллллллл)(лллллллллллллллллллллллл
лїїїїїїїїїїїїїммллллллллл_лллллллммїїїїїїїїїїїїїїїл
лїїїїїїїїїїїмллллллл  ў        лллллмїїїїїїїїїїїїїл
лїїїїїїїїїмллллллллл      ў  ў лллллллмїїїїїїїїїїїл
лїїїїїїїмллллллллллл ў  ў      лллллллллмїїїїїїїїїл
лїїїїїїллллллллллллл        ў  лллллллллллїїїїїїїїл
лїїїїїлллллллллллллллллл лллллллллллллллллїїїїїїїл
лїїїїлллллллллл          ллллллллллллллллллїїїїїїл
лїїїллллллллллл ллллллллллллллллллллллллллллїїїїїл
лїїїллллллллллл лллл             оллллллллллїїїїїл
лїїїллллллллллл_лллл лллллллллллн_оллллллллллїїїїїл
лїїїлллллллл         ўл    л           ллллллїїїїїл
лїїїлллллллл ў   o    л ў  л     o   ў ллллллїїїїїл
лїїїїллллллл        ў л   ўл           лллллїїїїїїл
лїїїїїлллллл  ў   ў   л    лў       ў  ллллїїїїїїїл
лїїїїїїпллллллллллллллл ў  лллллл лллллллпїїїїїїїїл
лїїїїїїїїпллллл_         |     лллллпїїїїїїїїїїл
лїїїїїїїїїїплллл лллллл  ў лллллллллпїїїїїїїїїїїїл
лїїїїїїїїїїїїллл      л    лллллллллїїїїїїїїїїїїїїл
лїїїїїїїїїїїїїлл  ў   лў   лллллллпїїїїїїїїїїїїїїїл
лїїїїїїїїїїїїїїл    ў л  ў ллллллїїїїїїїїїїїїїїїїїл
лїїїїїїїїїїїїїїл      л    лллллїїїїїїїїїїїїїїїїїїл
лїїїїїїїїїїїїїїллл лллллллллллллїїїїїїїїїїїїїїїїїїл
лїїїїїїїїїїїїїїллл лїлїлїлїлїлїлїїїїїїїїїїїїїїїїїїл
лллллллллллллллллл ллїлїлїлїлїлїллллллллллллллллллл
ллллллллллллллллл   ллллллллллллллллллллллллллллллл
