ллллллллллллллллллллллллллллллллллллллллллллллллллл
л                                                 л
л                                                 л
л                                                 л
л                                                л
л                     / |                         л
л                       \                        л
л      \ | /          /                           л
л       |                                        л
л       /\                                       л
л                                       /\       л
л                                                 л
л                                       /|        л
л                                         \       л
л           \ /                                   л
л           \|-                                   л
л                  / /                           л
л                 -- \                           л
л                                                 л
л                                                 л
л                                                 л
л                                                 л
л                                                 л
л                                                 л
лллллллллллллллллл лллллллллллллллллллллллллллллллл
лллллллллллллллллл_лллллллллллллллллллллллллллллллл