ллллллллллллллллллллллллллллллллллллллллллллллллллл
л                                                 л
л                                                 л
л                                                 л
л                       o                         л
л                     / |                         л
л        o               \                        л
л      \ | /          /                           л
л       |!                                        л
л       /\                               o        л
л                                       /!\       л
л                                                 л
л                                       /|        л
л                                         \       л
л           \ /                                   л
л           \|-                                   л
л            o      / /                           л
л                 o-- \                           л
л                                                 л
л                                                 л
л                                                 л
л                                                 л
л                                                 л
л                                                 л
лллллллллллллллллл лллллллллллллллллллллллллллллллл
лллллллллллллллллл_лллллллллллллллллллллллллллллллл