л*ллллллллллллллллллллллллллллллллллллллллллллллллл
н          лл   л               л                 *
н л ллл лпллл л   ллллллллллллл л л лллллллллпплл о
н л л л лL  л ллллл       л   л л л л       л Mо  о
н л л л лмл л л   л ллллл л л л ллл л ллллл л лл лл
н л л л л       л       л   л       л л           о
н л л л л ллллллл ллллл ллллллллллл л ллллллллллл о
н л   л л л   л л       л     л   л   л        л  о
н ллллл ллл л л ллллл ллл ллл л л ллллл лллллппл лл
н л     н!  л     л   л   л   л л л           Nо  о
н л лллллпллллл л л ллл ллл ллл л лл ллллллллллпппл
  л      Kл   л л   л   л       л      А        O  
н л лллллмл л л ллллл л л ллллллл лл ллллллллллмммл
н л л       л л   л   л л н       л    л          о
н л л л ллллл ллл л ллл л ллл л лллллл лллллллллл о
н     л         л   л   л   л л      л    л       о
лллллллллпл ллллл ллл ллллл л ллллл ллл лллл оплллл
н        Iл л   л   л  л !о л л   л   л л    оX   о
н лллллллмл л л ллл лл   лл л л л л л л л лл оллл о
*             л     л  л    л   л     л    л      о
ллллллллллллллллллллллллллллллллллллллллллллллллл*л
